11001100111111110101
01001000101100011001
11010011100111101111
10011110000010100100
10111001011100100101
11101000111111100101
10001101000010000100
11110101010110000100
11101111100010011101
10111000101010011110
11001000010011111101
01101001110100111110
00111100101011111010
10001001110111110011
00001010111010010001
11111101001001101011
10010101111011111010
10111011010110110111
11101001101000011100
00011111001110011111 
